{
    "width": 10,
    "height": 10,
    "layers": [
    {
        "terrain": [
            2,2,2,2,2,2,2,2,2,2,
            2,2,2,2,2,2,2,2,2,2,
            2,2,2,2,2,2,2,2,2,2,
            2,2,2,2,2,2,2,2,2,2,
            2,2,2,2,2,2,2,2,2,2,
            2,2,2,2,2,2,2,2,2,2,
            2,2,2,2,5,5,5,5,2,2,
            2,2,2,2,5,5,5,5,2,2,
            2,2,2,2,15,15,15,15,2,2,
            2,2,2,2,2,2,2,2,2,2
        ],
        "over_terrain": [
            0,0,0,0,0,0,0,0,0,0,
            0,0,0,0,0,0,0,0,0,0,
            0,0,0,0,0,0,0,0,0,0,
            0,0,0,0,0,0,0,0,0,0,
            0,0,0,0,0,0,0,0,0,0,
            0,0,0,0,0,0,0,0,0,0,
            0,0,0,0,0,0,0,0,0,0,
            0,0,0,0,0,0,0,0,0,0,
            0,0,0,0,0,0,0,0,0,0,
            0,0,0,0,0,0,0,0,0,0
        ]
    },
    {
        "terrain": [
            0,0,0,0,0,0,0,0,0,0,
            0,0,0,0,0,0,0,0,0,0,
            0,0,0,0,0,0,0,0,0,0,
            0,0,0,0,0,0,0,0,0,0,
            0,0,0,0,0,0,0,0,0,0,
            0,0,0,0,0,0,0,0,0,0,
            0,0,0,0,6,6,5,5,0,0,
            0,0,0,0,6,6,5,5,0,0,
            0,0,0,0,0,0,0,0,0,0,
            0,0,0,0,0,0,0,0,0,0
        ],
        "over_terrain": [
            0,0,0,0,0,0,0,0,0,0,
            0,0,0,0,0,0,0,0,0,0,
            0,0,0,0,0,0,0,0,0,0,
            0,0,0,0,0,0,0,0,0,0,
            0,0,0,0,0,0,0,0,0,0,
            0,0,0,0,0,0,0,0,0,0,
            0,0,0,0,0,0,0,0,0,0,
            0,0,0,0,0,0,0,0,0,0,
            0,0,0,0,0,0,0,0,0,0,
            0,0,0,0,0,0,0,0,0,0
        ]
    },
    {
        "terrain": [
            0,0,0,0,0,0,0,0,0,0,
            0,0,0,0,0,0,0,0,0,0,
            0,0,0,0,0,0,0,0,0,0,
            0,0,0,0,0,0,0,0,0,0,
            0,0,0,0,0,0,0,0,0,0,
            0,0,0,0,0,0,0,0,0,0,
            0,0,0,0,0,0,6,6,0,0,
            0,0,0,0,0,0,6,6,0,0,
            0,0,0,0,0,0,0,0,0,0,
            0,0,0,0,0,0,0,0,0,0
        ],
        "over_terrain": [
            0,0,0,0,0,0,0,0,0,0,
            0,0,0,0,0,0,0,0,0,0,
            0,0,0,0,0,0,0,0,0,0,
            0,0,0,0,0,0,0,0,0,0,
            0,0,0,0,0,0,0,0,0,0,
            0,0,0,0,0,0,0,0,0,0,
            0,0,0,0,0,0,0,0,0,0,
            0,0,0,0,0,0,0,0,0,0,
            0,0,0,0,0,0,0,0,0,0,
            0,0,0,0,0,0,0,0,0,0
        ]
    },
    {
        "terrain": [
            0,0,0,0,0,0,0,0,0,0,
            0,0,0,0,0,0,0,0,0,0,
            0,0,0,0,0,0,0,0,0,0,
            0,0,0,0,0,0,0,0,0,0,
            0,0,0,0,0,0,0,0,0,0,
            0,0,0,0,0,0,0,0,0,0,
            0,0,0,0,0,0,6,6,0,0,
            0,0,0,0,0,0,6,6,0,0,
            0,0,0,0,0,0,0,0,0,0,
            0,0,0,0,0,0,0,0,0,0
        ],
        "over_terrain": [
            0,0,0,0,0,0,0,0,0,0,
            0,0,0,0,0,0,0,0,0,0,
            0,0,0,0,0,0,0,0,0,0,
            0,0,0,0,0,0,0,0,0,0,
            0,0,0,0,0,0,0,0,0,0,
            0,0,0,0,0,0,0,0,0,0,
            0,0,0,0,0,0,0,0,0,0,
            0,0,0,0,0,0,0,0,0,0,
            0,0,0,0,0,0,0,0,0,0,
            0,0,0,0,0,0,0,0,0,0
        ]
    }
]

}
