{
    "width": 10,
    "height": 10,
    "layers": [
    {
        "terrain": [
            2,0,2,2,2,2,2,2,2,2,
            0,2,0,2,2,2,2,2,2,2,
            2,0,2,2,2,2,2,2,2,2,
            0,2,2,2,2,2,2,2,2,2,
            2,0,2,2,2,2,2,2,2,2,
            2,2,2,2,2,2,2,2,2,2,
            2,2,2,2,0,0,0,0,2,2,
            2,2,2,2,0,0,0,0,2,2,
            2,2,2,2,2,2,2,2,2,2,
            2,2,2,2,2,2,2,2,2,2
        ],
        "over_terrain": [
            0,0,0,0,0,0,0,0,0,0,
            0,0,0,0,0,0,0,0,0,0,
            0,0,0,0,0,0,0,0,0,0,
            0,0,0,0,0,0,0,0,0,0,
            0,0,0,0,0,0,0,0,0,0,
            0,0,0,0,0,0,0,0,0,0,
            0,0,0,0,0,0,0,0,0,0,
            0,0,0,0,0,0,0,0,0,0,
            0,0,0,0,0,0,0,0,0,0,
            0,0,0,0,0,0,0,0,0,0
        ]
    },
    {
        "terrain": [
            0,0,0,0,0,0,0,0,0,0,
            0,0,0,0,0,0,0,0,0,0,
            0,0,0,0,0,0,0,0,0,0,
            0,0,0,0,0,0,0,0,0,0,
            0,0,0,0,0,0,0,0,0,0,
            0,0,0,0,0,0,0,0,0,0,
            0,0,0,0,6,6,0,0,0,0,
            0,0,0,0,6,6,0,0,0,0,
            0,0,0,0,0,0,0,0,0,0,
            0,0,0,0,0,0,0,0,0,0
        ],
        "over_terrain": [
            0,0,0,0,0,0,0,0,0,0,
            0,0,0,0,0,0,0,0,0,0,
            0,0,0,0,0,0,0,0,0,0,
            0,0,0,0,0,0,0,0,0,0,
            0,0,0,0,0,0,0,0,0,0,
            0,0,0,0,0,0,0,0,0,0,
            0,0,0,0,0,0,0,0,0,0,
            0,0,0,0,0,0,0,0,0,0,
            0,0,0,0,0,0,0,0,0,0,
            0,0,0,0,0,0,0,0,0,0
        ]
    },
    {
        "terrain": [
            0,0,0,0,0,0,0,0,0,0,
            0,0,0,0,0,0,0,0,0,0,
            0,0,0,0,0,0,0,0,0,0,
            0,0,0,0,0,0,0,0,0,0,
            0,0,0,0,0,0,0,0,0,0,
            0,0,0,0,0,0,0,0,0,0,
            0,0,0,0,0,0,6,6,0,0,
            0,0,0,0,0,0,6,6,0,0,
            0,0,0,0,0,0,0,0,0,0,
            0,0,0,0,0,0,0,0,0,0
        ],
        "over_terrain": [
            0,0,0,0,0,0,0,0,0,0,
            0,0,0,0,0,0,0,0,0,0,
            0,0,0,0,0,0,0,0,0,0,
            0,0,0,0,0,0,0,0,0,0,
            0,0,0,0,0,0,0,0,0,0,
            0,0,0,0,0,0,0,0,0,0,
            0,0,0,0,0,0,0,0,0,0,
            0,0,0,0,0,0,0,0,0,0,
            0,0,0,0,0,0,0,0,0,0,
            0,0,0,0,0,0,0,0,0,0
        ]
    }
]

}
